12s	12s rna	small subunit ribosomal rna	
16s	16s rna	large subunit ribosomal rna	
abcd2	ATP binding cassette subfamily D member 2			
adarb2	adenosine deaminase RNA specific B2			
adnp	activity-dependent neuroprotector homeobox			
adrb2	beta-2 adrenergic receptor			
akap11	A-kinase anchoring protein 11			
akap12	A-kinase anchoring protein 12			
amotl1	angiomotin like 1			
angptl1	angiopoietin like 1			
ank3	ankyrin 3			
ankrd50	ankyrin repeat domain protein 50	ankyrin repeat domain 50		
apc	APC regulator of WNT signaling pathway			
arid1b	AT-rich interaction domain 1B			
arid5b	AT-rich interaction domain 5B			
arsi	arylsulfatase family member I			
asxl3	ASXL transcriptional regulator 3			
atxn1	ataxin 1			
b3galt2	beta-1,3-galactosyltransferase 2			
bcl11a	BAF chromatin remodeling complex subunit BCL11A			
bcl9	BCL9 transcription coactivator			
bcor	BCL6 corepressor			
bdnf	brain derived neurotrophic factor	brain-derived neurotrophic factor		
begain	brain enriched guanylate kinase associated			
bend3	BEN domain containing 3			
bicd1	BICD cargo adaptor 1			
bicral	BRD4 interacting chromatin remodeling complex associated protein like			
birc6	baculoviral IAP repeat containing 6			
bmpr2	bone morphogenetic protein receptor type 2			
bnc1	basonuclin 1			
bptf	bromodomain phd finger transcription factor			
bsn	bassoon presynaptic cytomatrix protein			
btbd17	BTB domain containing 17			
camsap1	calmodulin regulated spectrin associated protein 1			
cand1	cand-1	cullin-associated and neddylation-dissociated 1	cullin associated and neddylation dissociated 1	
ccdc80	coiled-coil domain containing 80			
ccdc85a	coiled-coil domain containing 85A			
ccdc92	coiled-coil domain containing 92			
cdc42ep4	CDC42 effector protein 4			
celsr1	cadherin EGF LAG seven-pass G-type receptor 1			
chd7	chromodomain helicase DNA binding protein 7			
chst1	carbohydrate sulfotransferase 1			
chst8	carbohydrate sulfotransferase 8			
cortbp1	cortactin-binding protein 1			
cox1	CO1	cytochrome oxidase subunit 1		
cox2	CO2	cytochrome oxidase subunit 2		
cpt2	carnitine palmitoyltransferase 2			
ctgf	connective tissue growth factor			
cttnbp2	cortactin binding protein 2			
cxcr4	C-X-C chemokine receptor type 4			
cytb	cytochrome b	cytochrome b apoenzyme	cyt b
dagla	diacylglycerol lipase alpha			
dapk1	death associated protein kinase 1			
dbc1	deleted in bladder cancer 1	brinp1
det1	det-1	de-etiolated-like protein 1		
disp1	disp-1	dispatched-like protein 1	dispatched RND transporter family member 1	
disp2	dispatched-like protein 2	dispatched RND transporter family member 2		
dll1	delta like canonical Notch ligand 1			
dmrt3	doublesex and mab-3 related transcription factor 3			
dmxl1	Dmx like 1			
dmxl2	Dmx like 2			
dnah3	dnah-3	axonemal dynein heavy chain 3	dynein axonemal heavy chain 3	
dolk	dolichol kinase			
dop1b	DOP1 leucine zipper like protein B			
dsel	dermatan sulfate epimerase-like protein	dermatan sulfate epimerase like		
dsp	desmoplakin			
dyrk2	dual specificity tyrosine phosphorylation regulated kinase 2			
elfn2	extracellular leucine rich repeat and fibronectin type III domain containing 2			
enc1	enc-1	ectodermal-neural cortex 1		
extl3	extl-3	exostoses multiple-like 3 protein	exostosin-like glycosyltransferase 3	
fam110b	family with sequence similarity 110 member B			
fam171a1	family with sequence similarity 171 member A1			
fat1	fat atypical cadherin 1			
fat2	fat atypical cadherin 2			
fat3	FAT atypical cadherin 3			
fat4	fat-4	fat tumor suppressor-like protein 4	FAT atypical cadherin 4	
fatj	fat-like cadherin FATJ protein			
fem1b	fem-1-like protein b			
ficd	fic domain-containing protein			
flrt3	fibronectin leucine rich transmembrane protein 3	leucine-rich repeat transmembrane protein FLRT3		
frem2	fras1 related extracellular matrix protein 2			
frem3	FRAS1 related extracellular matrix 3			
fut9	fucosyltransferase 9 alpha			
fzd4	frizzled family receptor 4	frizzled class receptor 4		
gcnt4	glucosaminyl (N-acetyl) transferase 4			
ghsr	growth hormone secretagogue receptor			
gpr12	G protein-coupled receptor 12			
gpr68	G protein-coupled receptor 68			
gpr75	G protein-coupled receptor 75			
gpr87	G protein-coupled receptor 87			
grin3a	glutamate ionotropic receptor NMDA type subunit 3A			
grm1	glutamate metabotropic receptor 1			
grm2	grm-2	glutamate receptor metabotropic 2		
grm5	glutamate metabotropic receptor 5			
h3a	histone 3a			
hivep1	HIVEP zinc finger 1			
hivep2	HIVEP zinc finger 2			
htr1e	5-hydroxytryptamine receptor 1E			
igsf10	immunoglobulin superfamily member 10			
igsf9b	immunoglobulin superfamily member 9B			
iqsec1	IQ motif and Sec7 domain ArfGEF 1			
jmjd1c	jumonji domain containing 1C			
jun	Jun proto-oncogene, AP-1 transcription factor subunit			
kank1	KN motif and ankyrin repeat domains 1			
kat6b	lysine acetyltransferase 6B			
kbtbd12	kelch repeat and BTB domain containing 12			
kbtbd4	kelch repeat and BTB domain containing 4			
kcnd3	voltage-gated potassium channel Kv4.3			
kcnf1	kcnf-1	potassium voltage-gated channel, subfamily f member 1	potassium voltage-gated channel, subfamily f, member 1	potassium voltage-gated channel modifier subfamily F member 1
kcnj15	potassium inwardly rectifying channel subfamily J member 15			
kcnj2	potassium inwardly rectifying channel subfamily J member 2			
kcns3	potassium voltage-gated channel modifier subfamily S member 3			
kcnv2	potassium voltage-gated channel modifier subfamily V member 2			
kiaa0232	kiaa0232-like protein			
kiaa1217	kiaa1217-like protein			
kiaa1239	kiaa1239-like protein	nwd2	NACHT and WD repeat domain containing 2
kiaa2013	kiaa2013-like protein			
kif1b	kinesin family member 1B			
kif26b	kinesin family member 26B			
klf5	Kruppel like factor 5			
klf7	Kruppel like factor 7			
klhl11	kelch like family member 11			
klhl31	kelch like family member 31			
klhl38	kelch like family member 38			
klhl40	kelch like family member 40			
kmt2a	lysine methyltransferase 2A			
lgr5	leucine rich repeat containing G protein-coupled receptor 5			
lig4	lig-4	atp-dependent ligase iv	ligase iv, dna, atp-dependent	atp-dependent dna ligase iv
lingo1	leucine rich repeat and ig domain containing 1			
lingo2	leucine rich repeat and ig domain containing 2			
lphn2	lphn-2	latrophilin 2	adgrl2	adhesion G protein-coupled receptor L2	
lrrn1	lrrn-1	leucine rich repeat neuronal 1	leucine-rich repeat neuronal protein 1	
lrrtm1	leucine rich repeat transmembrane neuronal 1			
lrrtm4	leucine rich repeat transmembrane neuronal 4			
maml2	mastermind like transcriptional coactivator 2			
map1a	microtubule associated protein 1A			
mast2	microtubule associated serine/threonine kinase 2			
mb21d2	mab-21 domain containing 2			
med1	mediator complex subunit 1			
mgat4c	mannosyl alpha-1,3--glycoprotein beta-1,4-n-acetylglucosaminyltransferase isozyme c			
mibp1	c-myc intron-binding protein 1			
mical3	microtubule associated monooxygenase, calponin and LIM domain containing 3			
mios	missing oocyte meiosis regulator	missing oocyte meiosis regulator-like protein		
moz	Human monocytic leukaemia zinc finger protein			
msh6	mutS homolog 6			
mycbp2	MYC binding protein 2			
ncoa6	nuclear receptor coactivator 6			
ncx1	sodium calcium exchanger			
nd2	nadh dehydrogenase subunit 2	nadh dehydrogenase subunit ii		
nd4	nadh dehydrogenase subunit 4	nadh dehydrogenase subunit iv		
ndnf	neuron derived neurotrophic factor			
ndst1	N-deacetylase and N-sulfotransferase 1			
nexmif	neurite extension and migration factor			
nfatc3	nuclear factor of activated T cells 3			
nfil3	nuclear factor, interleukin 3 regulated			
nfm	nf-m	neurofilament subunit M			
nhs	nance-horan syndrome protein	NHS actin remodeling regulator		
nhsl1	NHS like 1			
nova1	NOVA alternative splicing regulator 1			
npas3	neuronal PAS domain protein 3			
npbwr1	neuropeptides B/W receptorÂ 			
nr3c2	nuclear receptor subfamily 3 group C member 2			
nuak1	NUAK family kinase 1			
olfml3	olfactomedin like 3			
panx2	panx-2	pannexin 2		
pcdh17	protocadherin 17			
pcdh18	protocadherin 18			
pclo	piccolo presynaptic cytomatrix protein			
pdp1	pdp-1	pyruvate dehyrogenase phosphatase catalytic subunit 1		
pdzrn3	PDZ domain containing ring finger 3			
pdzrn4	PDZ domain containing ring finger 4			
pik3cg	phosphatidylinositol-4,5-bisphosphate 3-kinase, catalytic subunit gamma			
plppr4	phospholipid phosphatase related 4			
plxna4	plexin A4			
pomc	proopiomelanocortin	pro-opiomelanocortin		
poz	kelch repeat and btb domain-containing 2 protein	kbtbd2		
ppl	periplakin			
prdm11	PR/SET domain 11			
prdm16	PR/SET domain 16			
prss23	serine protease 23			
pxdn	peroxidasin			
pycr1	pyrroline-5-carboxylate reductase 1			
rag1	recombination activating 1	recombination activating gene 1		
rag2	recombination activating protein 2	rag-2		
rai1	retinoic acid induced 1			
ranbp2	RAN binding protein 2			
rasal2	RAS protein activator like 2			
rbm15	RNA binding motif protein 15			
rhod	rhodopsin			
rhov	ras homolog family member V			
rin2	Ras and Rab interactor 2			
rnf103	ring finger protein 103			
rnf139	ring finger protein 139			
ror2	receptor tyrosine kinase-like orphan receptor 2	receptor tyrosine kinase like orphan receptor 2		
rreb1	ras responsive element binding protein 1			
s1pr1	sphingosine-1-phosphate receptor 1			
sacs	sacsin	spastic ataxia of charlevoix-saguenay	sacsin molecular chaperone	
sall1	sal-like protein 1			
sall3	spalt like transcription factor 3			
sema6a	semaphorin 6A			
sema6d	semaphorin 6D			
setbp1	SET binding protein 1			
sh3bp4	sh3-domain binding protein 4			
sh3pxd2a	SH3 and PX domains 2A			
shank2	SH3 and multiple ankyrin repeat domains 2			
shroom3	shroom family member 3			
sia	seventh in absentia			
siah2	siah E3 ubiquitin protein ligase 2			
sim1	SIM bHLH transcription factor 1			
sipa1l1	signal induced proliferation associated 1 like 1			
skil	SKI like proto-oncogene			
slc18a3	solute carrier family 18 member A3			
slc26a2	solute carrier family 26 member 2			
slc8a3	solute carrier family 8 member 3	solute carrier family 8 member A3		
slitrk1	slit and ntrk-like family, member 1			
smcr8	Smith-Magenis syndrome chromosome region candidate 8 protein			
snrk	SNF related kinase			
socs5	suppressor of cytokine signaling 5			
sorbs2	sorbin and SH3 domain containing 2			
sp4	Sp4 transcription factor			
spen	spen family transcriptional repressor			
stard13	StAR related lipid transfer domain containing 13			
ston1	stonin 1			
ston2	stonin 2			
svep1	sushi, von willebrand factor type a, egf and pentraxin domain containing protein 1	sushi, von Willebrand factor type A, EGF and pentraxin domain containing 1		
syne1	spectrin repeat containing nuclear envelope protein 1			
tenm2	teneurin transmembrane protein 2			
tenm4	teneurin transmembrane protein 4			
tex2	testis expressed 2			
tiam1	T cell lymphoma invasion and metastasis 1			
tmem132d	transmembrane protein 132D			
tnrc6c	trinucleotide repeat containing adaptor 6C			
trpm3	transient receptor potential cation channel subfamily M member 3			
tshz1	teashirt zinc finger homeobox 1			
tshz2	teashirt zinc finger homeobox 2			
tshz3	teashirt zinc finger homeobox 3			
ttbk2	tau tubulin kinase 2			
ttn	titin			
tyr	tyrosinase			
uhrf1bp1l	UHRF1 binding protein 1 like			
usf3	upstream transcription factor family member 3			
vcpip1	valosin containing protein interacting protein 1			
vps18	VPS18 core subunit of CORVET and HOPS complexes			
wnt7a	Wnt family member 7A			
ythdf3	YTH N6-methyladenosine RNA binding protein 3			
zbed4	zbed-4	zinc finger bed-type containing protein 4	zinc finger bed-type containing 4 protein	
zbtb21	zinc finger and BTB domain containing 21			
zbtb34	zinc finger and BTB domain containing 34			
zc3h12c	zinc finger CCCH-type containing 12C			
zeb1	zinc finger E-box binding homeobox 1			
zeb2	zinc finger E-box binding homeobox 2			
zfhx3	zinc finger homeobox 3			
zfhx4	zinc finger homeobox 4			
zfpm2	zinc finger protein, FOG family member 2			
zhx2	zinc fingers and homeoboxes 2			
znf142	zinc finger protein 142			
znf148	zinc finger protein 148			
znf292	zinc finger protein 292			
znf423	zinc finger protein 423			
znf521	zinc finger protein 521			
znf536	zinc finger protein 536			
znf644	zinc finger protein 644			
